##########################################
##--------------##----------------------##
######--######--##--#########-########--##
##------##-------A--##--------------##--##
##--##################--##########--##--##
##----------------------##----------##--##
##--############-#########--##########--##
##------##------------------##------##--##
##########--##################--######--##
##----------##------##----------##------##
##--##########--##--##---#--##--##--######
##--##----------##--##---#--##--##------##
##--##--##########--##---#--##########--##
##--##----------##--AP---#--##------##--##
##--##########--##########--##--##--##--##
##----------##--##--------------##--##--##
##########--##--##################--##--##
##----------##------------------##--##--##
##--##########################--##--##--##
##------------------A-----------##------##
##########################################