#############
#---#-A-#---#
#-#-#-#-#-#-#
###---#---#-#
#-#-#---#---#
#-####--###-#
#---A-P---#-#
#-#-#######-#
#-#---##----#
#-#-#-##--#-#
#-###-##-##-#
#--------A--#
#############