##########
#-A------#
#--------#
#--------#
#---AP---#
#--------#
#--------#
#--------#
#------A-#
##########