##########
#-A---#--#
#-#---#--#
#-#-#----#
#--A#P-#-#
#---#----#
###---##-#
#---#-#--#
#-A-#----#
##########