#####################
#A----#-----#-#-----#
#-#-#-#-###---#-#-###
#-#-#---#---#---#---#
###-#####-#####-###-#
#---#-----A---#-#---#
#-###-#######-###-#-#
#---#-#---#---#---#-#
###-#---#-###-#-#####
#---#-#-#---#-#-#---#
#-#####-###-#-#-#-#-#
#-----#---#-#-#---#-#
#-###-###-###-#####-#
#-#--A--#---#---#---#
#-#-#######-###-#-#-#
#-#-------#-#-#---#-#
#-#######-#-#-#####-#
#-#-----#---#-#-----#
#-#-###-#####-#-#####
#-----#------------P#
#####################